0	5	5	0	0	4	4	4	4	3	3	3	3	7	7	0	0	2	2	0	0
5	5	5	5	7	7	7	7	4	4	3	3	5	5	7	7	2	2	2	2	0
0	5	5	7	7	18	18	7	7	2	2	5	5	7	7	18	18	2	2	0	0
5	5	4	4	18	18	303	303	2	2	5	5	5	5	203	203	18	18	3	3	0
0	4	4	18	18	303	303	2	2	0	0	0	0	7	7	203	203	18	18	3	3
0	0	4	4	4	4	0	0	3	3	0	0	7	7	0	0	3	3	3	3	0
0	18	18	703	703	0	0	0	0	3	3	3	3	0	0	0	0	503	503	18	18
0	0	18	18	703	703	3	3	4	4	201	201	3	3	3	3	503	503	18	18	0
0	18	18	703	703	0	0	0	0	4	4	4	4	0	0	0	0	503	503	18	18
5	5	5	5	5	5	0	0	4	4	0	0	5	5	0	0	2	2	2	2	0
0	5	5	18	18	203	203	5	5	0	0	0	0	5	5	303	303	18	18	2	2
0	0	0	0	18	18	203	203	5	5	2	2	5	5	303	303	18	18	0	0	0
0	7	7	0	0	18	18	5	5	3	3	2	2	4	4	18	18	0	0	5	5
7	7	7	7	2	2	5	5	3	3	4	4	7	7	4	4	4	4	5	5	0
0	7	7	2	2	2	2	2	2	3	3	4	4	7	7	7	7	5	5	5	5
0	0	701	701	0	0	0	0	301	301	0	0	401	401	0	0	0	0	501	501	0
