0	1	1	1	1	1	1	2	2	2	2	1	1	1	1	3	3	3	3	3	3
0	0	1	1	1	1	4	4	4	4	4	4	4	4	4	4	3	3	3	3	0
0	0	0	1	1	4	4	2	2	2	2	2	2	2	2	4	4	3	3	0	0
0	0	0	0	4	4	3	3	1	1	1	1	1	1	3	3	4	4	0	0	0
0	0	0	0	0	3	3	1	1	4	4	4	4	1	1	3	3	0	0	0	0
0	0	0	0	3	3	1	1	4	4	4	4	4	4	1	1	3	3	0	0	0
0	1	1	0	0	3	3	1	1	4	4	4	4	1	1	3	3	0	0	2	2
0	0	1	1	4	4	3	3	1	1	2	2	1	1	3	3	4	4	2	2	0
0	1	1	3	3	4	4	3	3	2	2	2	2	3	3	4	4	1	1	2	2
0	0	3	3	3	3	4	4	2	2	2	2	2	2	4	4	1	1	1	1	0
0	3	3	3	3	3	3	2	2	201	201	2	2	2	2	1	1	1	1	1	1
4	4	4	4	4	4	4	4	0	0	0	0	3	3	3	3	3	3	3	3	0
0	4	4	4	4	4	4	0	0	1	1	0	0	3	3	3	3	3	3	0	0
0	0	2	2	2	2	0	0	1	1	1	1	0	0	4	4	4	4	0	0	0
0	2	2	2	2	2	2	1	1	1	1	1	1	4	4	4	4	4	4	0	0
2	2	2	2	2	2	2	2	0	0	0	0	4	4	4	4	4	4	4	4	0
0	1	1	1	1	4	4	4	4	3	3	3	3	2	2	2	2	1	1	1	1
0	0	101	101	0	0	401	401	0	0	3	3	0	0	201	201	0	0	101	101	0
