0	0	0	0	0	0	0	0	0	7	7	7	7	0	0	0	0	0	0	0	0
0	0	0	0	0	0	0	0	7	7	0	0	7	7	0	0	0	0	0	0	0
0	0	0	0	0	0	0	0	0	7	7	7	7	0	0	0	0	0	0	0	0
0	0	0	0	0	0	0	0	0	0	13	13	0	0	0	0	0	0	0	0	0
0	0	0	0	0	0	0	0	0	13	13	13	13	0	0	0	0	0	0	0	0
0	0	13	13	4	4	5	5	2	2	2	2	7	7	4	4	2	2	13	13	0
0	13	13	4	4	4	4	5	5	2	2	2	2	7	7	4	4	2	2	13	13
0	0	5	5	4	4	13	13	0	0	5	5	0	0	13	13	5	5	7	7	0
0	13	13	5	5	5	5	2	2	2	2	5	5	4	4	5	5	7	7	13	13
0	0	13	13	5	5	5	5	7	7	7	7	4	4	4	4	7	7	13	13	0
0	0	0	13	13	0	0	0	0	0	0	0	0	0	0	0	0	13	13	0	0
0	0	0	0	13	13	0	0	401	401	0	0	501	501	0	0	13	13	0	0	0
0	0	0	7	7	7	7	4	4	4	4	5	5	5	5	2	2	2	2	0	0
0	0	7	7	701	701	7	7	0	0	0	0	0	0	2	2	201	201	2	2	0
0	0	0	7	7	7	7	0	0	0	0	0	0	0	0	2	2	2	2	0	0
