0	0	5	5	5	5	5	5	5	5	5	5	5	5	5	5	5	5	5	5	0
0	0	0	704	704	704	704	704	704	704	704	704	704	704	704	704	704	704	704	0	0
0	0	4	4	4	4	4	4	4	4	4	4	2	2	2	2	2	2	2	2	0
0	0	0	7	7	7	7	7	7	7	7	5	5	5	5	5	5	5	5	0	0
0	0	0	0	404	404	404	404	404	404	404	404	404	404	404	404	404	404	0	0	0
0	0	0	0	0	5	5	5	5	5	5	2	2	2	2	2	2	0	0	0	0
0	0	0	0	0	0	404	404	404	404	404	404	404	404	404	404	0	0	0	0	0
0	0	0	0	0	204	204	201	201	7	7	7	7	501	501	504	504	0	0	0	0
