0	0	0	0	6	6	0	0	0	0	4	4	0	0	0	0	2	2	0	0	0
0	0	0	7	7	6	6	0	0	4	4	5	5	0	0	2	2	5	5	0	0
0	0	7	7	0	0	6	6	4	4	0	0	5	5	2	2	0	0	5	5	0
0	2	2	2	2	2	2	7	7	7	7	7	7	7	7	5	5	5	5	5	5
4	4	4	4	4	4	0	0	0	0	0	0	0	0	4	4	4	4	5	5	0
0	4	4	0	0	2	2	6	6	6	6	6	6	6	6	0	0	4	4	0	0
4	4	4	4	2	2	0	0	5	5	5	5	0	0	7	7	7	7	7	7	0
0	2	2	0	0	0	0	2	2	0	0	4	4	0	0	0	0	4	4	0	0
0	0	2	2	0	0	2	2	7	7	7	7	4	4	0	0	4	4	0	0	0
0	0	0	2	2	2	2	7	7	7	7	5	5	4	4	4	4	0	0	0	0
0	0	5	5	2	2	4	4	4	4	0	0	5	5	4	4	0	0	0	0	0
0	5	5	0	0	0	0	4	4	0	0	0	0	6	6	6	6	6	6	0	0
0	0	5	5	5	5	2	2	2	2	0	0	0	0	6	6	6	6	0	0	0
0	0	0	0	0	2	2	2	2	2	2	2	2	7	7	7	7	2	2	0	0
0	0	6	6	6	6	0	0	5	5	5	5	5	5	7	7	7	7	2	2	0
0	0	0	0	0	0	0	4	4	4	4	6	6	6	6	0	0	0	0	0	0
0	0	0	0	0	0	5	5	2	2	2	2	4	4	4	4	0	0	0	0	0
0	0	0	0	0	5	5	5	5	2	2	2	2	4	4	4	4	0	0	0	0
0	0	0	0	6	6	7	7	7	7	7	7	5	5	5	5	2	2	0	0	0
0	0	0	6	6	7	7	7	7	6	6	6	6	5	5	2	2	2	2	0	0
0	0	0	0	6	6	7	7	7	7	601	601	5	5	5	5	2	2	0	0	0
0	0	0	0	0	2	2	2	2	4	4	4	4	7	7	7	7	0	0	0	0
0	0	0	0	0	0	2	2	4	4	4	4	7	7	7	7	0	0	0	0	0
0	0	0	7	7	2	2	0	0	0	0	6	6	6	6	5	5	5	5	5	5
0	0	2	2	7	7	0	0	6	6	6	6	6	6	7	7	7	7	0	0	0
0	0	0	2	2	4	4	4	4	0	0	0	0	7	7	7	7	2	2	2	2
0	0	0	0	5	5	0	0	7	7	4	4	5	5	5	5	0	0	2	2	0
0	0	0	5	5	0	0	7	7	4	4	4	4	0	0	0	0	0	0	2	2
0	0	0	0	5	5	0	0	2	2	2	2	6	6	6	6	6	6	6	6	0
0	0	0	0	0	601	601	6	6	0	0	0	0	7	7	701	701	7	7	0	0
