0	4	4	0	0	2	2	0	0	5	5	0	0	7	7	0	0	3	3	0	0
4	4	3	3	2	2	7	7	5	5	2	2	7	7	4	4	3	3	5	5	0
0	4	4	302	302	2	2	702	702	5	5	202	202	7	7	402	402	3	3	502	502
7	7	4	4	4	4	2	2	2	2	5	5	5	5	7	7	7	7	3	3	0
0	7	7	4	4	2	2	2	2	5	5	7	7	7	7	2	2	0	0	3	3
7	7	7	7	4	4	0	0	5	5	0	0	7	7	2	2	0	0	3	3	0
0	4	4	4	4	0	0	7	7	0	0	7	7	0	0	2	2	3	3	3	3
0	0	4	4	0	0	0	0	7	7	7	7	0	0	0	0	0	0	3	3	0
0	0	0	7	7	0	0	3	3	0	0	5	5	0	0	2	2	0	0	4	4
7	7	7	7	3	3	3	3	5	5	5	5	2	2	2	2	4	4	4	4	0
0	7	7	0	0	3	3	0	0	5	5	0	0	2	2	0	0	4	4	0	0
0	0	7	7	3	3	5	5	5	5	3	3	3	3	2	2	4	4	0	0	0
0	7	7	3	3	5	5	0	0	0	0	3	3	0	0	4	4	0	0	0	0
7	7	0	0	0	0	5	5	5	5	0	0	3	3	0	0	4	4	0	0	0
0	7	7	3	3	0	0	4	4	0	0	5	5	0	0	7	7	5	5	2	2
301	301	0	0	401	401	0	0	501	501	0	0	701	701	0	0	201	201	5	5	0
