0	0	8	8	7	7	10	10	4	4	5	5	5	5	3	3	7	7	8	8	0
0	0	0	8	8	7	7	10	10	4	4	5	5	3	3	7	7	8	8	0	0
0	0	8	8	7	7	10	10	4	4	5	5	5	5	3	3	7	7	8	8	0
0	8	8	7	7	10	10	4	4	5	5	5	5	5	5	3	3	7	7	8	8
0	0	8	8	7	7	10	10	4	4	5	5	5	5	3	3	7	7	8	8	0
0	0	0	8	8	7	7	10	10	4	4	5	5	3	3	7	7	8	8	0	0
0	0	8	8	7	7	10	10	4	4	5	5	5	5	3	3	7	7	8	8	0
0	801	801	701	701	1001	1001	401	401	5	5	501	501	5	5	301	301	701	701	801	801
