0	0	0	0	0	0	9	9	9	9	9	9	9	9	9	9	0	0	0	0	0
0	0	0	0	0	0	0	0	0	8	8	1	1	0	0	0	0	0	0	0	0
0	0	0	0	0	0	0	0	8	8	1	1	0	0	0	0	0	0	0	0	0
0	0	0	0	0	0	0	0	0	8	8	1	1	0	0	0	0	0	0	0	0
0	0	0	0	0	0	0	0	8	8	1	1	0	0	0	0	0	0	0	0	0
0	0	0	0	0	0	0	0	0	8	8	1	1	0	0	0	0	0	0	0	0
0	0	0	0	10	10	10	10	10	10	1	1	10	10	10	10	10	10	0	0	0
0	0	0	0	0	8	8	8	8	8	8	8	8	1	1	1	1	0	0	0	0
0	0	0	0	1	1	1	1	1	1	1	1	10	10	10	10	10	10	0	0	0
0	0	0	0	0	9	9	9	9	9	9	901	901	9	9	9	9	0	0	0	0
