0	0	2	2	5	5	0	0	5	5	7	7	0	0	7	7	5	5	0	0	0
0	7	7	3004	3004	7	7	2	2	3004	3004	2	2	4	4	3004	3004	4	4	0	0
0	0	4	4	2	2	0	0	4	4	5	5	0	0	7	7	2	2	7	7	0
0	0	0	5	5	5	5	7	7	7	7	4	4	4	4	5	5	3004	3004	5	5
0	0	7	7	3004	3004	4	4	2	2	2	2	2	2	3004	3004	4	4	2	2	0
0	7	7	7	7	2	2	4	4	7	7	7	7	7	7	5	5	5	5	2	2
0	0	7	7	2	2	0	0	0	0	201	201	0	0	0	0	5	5	2	2	0
0	0	0	5	5	5	5	4	4	4	4	5	5	5	5	2	2	2	2	0	0
0	0	0	0	7	7	3004	3004	2	2	0	0	7	7	3004	3004	4	4	0	0	0
0	0	0	0	0	7	7	2	2	0	0	0	0	7	7	4	4	0	0	0	0
0	0	0	0	0	0	5	5	5	5	0	0	2	2	2	2	0	0	0	0	0
0	0	0	0	0	0	0	501	501	5	5	2	2	201	201	0	0	0	0	0	0
