0	0	0	0	5	5	0	0	4	4	4	4	0	0	7	7	0	0	0	0	0
0	0	0	5	5	3	3	3	3	4	4	3	3	3	3	7	7	7	7	0	0
5	5	5	5	3	3	202	202	202	202	502	502	502	502	3	3	7	7	0	0	0
0	5	5	2	2	3	3	3	3	3	3	3	3	3	3	7	7	4	4	4	4
4	4	5	5	2	2	7	7	5	5	5	5	5	5	5	5	7	7	4	4	0
0	4	4	3	3	2	2	7	7	5	5	5	5	5	5	3	3	4	4	5	5
4	4	3	3	2	2	7	7	2	2	3	3	3	3	3	3	4	4	5	5	0
0	4	4	3	3	7	7	7	7	2	2	4	4	4	4	4	4	5	5	0	0
7	7	4	4	3	3	5	5	7	7	2	2	3	3	3	3	7	7	5	5	0
0	7	7	3	3	5	5	0	0	2	2	3	3	0	0	7	7	5	5	0	0
0	0	701	701	5	5	5	5	201	201	301	301	7	7	7	7	501	501	0	0	0
