13	13	13	13	13	13	13	13	13	13	14	14	13	13	13	13	13	13	13	13	0
0	0	0	5	5	3	3	2	2	0	0	0	0	3	3	5	5	4	4	0	0
0	0	5	5	0	0	3	3	2	2	14	14	3	3	5	5	0	0	4	4	0
0	4	4	3	3	2	2	5	5	0	0	0	0	4	4	3	3	2	2	5	5
0	0	4	4	3	3	2	2	5	5	0	0	4	4	3	3	2	2	5	5	0
0	0	0	4	4	3	3	2	2	5	5	4	4	3	3	2	2	5	5	0	0
13	13	13	13	13	13	13	13	13	13	14	14	13	13	13	13	13	13	13	13	0
0	3	3	4	4	5	5	2	2	4	4	3	3	2	2	5	5	3	3	4	4
3	3	2	2	5	5	3	3	4	4	5	5	2	2	4	4	3	3	2	2	0
0	2	2	4	4	3	3	2	2	5	5	3	3	4	4	5	5	2	2	4	4
2	2	4	4	3	3	5	5	2	2	14	14	3	3	5	5	2	2	4	4	0
0	2	2	4	4	5	5	4	4	2	2	3	3	2	2	5	5	2	2	4	4
0	0	2	2	5	5	4	4	13	13	5	5	13	13	2	2	5	5	4	4	0
0	3	3	3	3	4	4	4	4	5	5	5	5	2	2	2	2	3	3	3	3
13	13	13	13	13	13	13	13	13	13	14	14	13	13	13	13	13	13	13	13	0
0	2	2	5	5	3	3	4	4	5	5	2	2	4	4	3	3	2	2	5	5
2	2	4	4	3	3	2	2	5	5	3	3	4	4	5	5	2	2	4	4	0
0	4	4	5	5	2	2	4	4	14	14	2	2	5	5	3	3	4	4	5	5
201	201	5	5	3	3	501	501	3	3	2	2	401	401	3	3	2	2	301	301	0
