0	0	0	0	0	0	0	0	6	6	6	6	0	0	0	0	0	0	0	0	0
0	0	0	0	0	0	0	6	6	6	6	6	6	0	0	0	0	0	0	0	0
0	0	9	9	9	9	9	9	6	6	6	6	8	8	8	8	8	8	0	0	0
0	9	9	9	9	9	9	9	9	0	0	8	8	8	8	8	8	8	8	0	0
0	0	8	8	8	8	0	0	6	6	6	6	6	6	0	0	9	9	9	9	0
0	8	8	8	8	8	8	6	6	6	6	6	6	6	6	9	9	9	9	9	9
0	0	9	9	9	9	0	0	8	8	8	8	8	8	0	0	6	6	6	6	0
0	9	9	901	901	9	9	8	8	8	8	801	801	8	8	6	6	601	601	6	6
