0	0	0	0	0	4	4	4	4	4	4	4	4	4	4	4	4	0	0	0	0
1	1	1	1	1	1	4	4	4	4	3	3	3	3	3	3	1	1	1	1	0
0	1	1	1	1	4	4	401	401	4	4	3	3	3	3	1	1	1	1	1	1
3	3	3	3	3	3	3	3	1	1	1	1	1	1	4	4	4	4	4	4	0
0	3	3	3	3	3	3	1	1	1	1	1	1	4	4	4	4	4	4	0	0
1	1	1	1	1	1	4	4	4	4	3	3	3	3	3	3	1	1	1	1	0
0	1	1	1	1	4	4	401	401	4	4	3	3	3	3	1	1	101	101	1	1
